1 1 1 1 1 1 1 1 1 1 1 1 1 1 1 1 1 1 1 1 1 1 1 1 1 1 1 1 1 1 1 1 1 1 1 1 1 1 1 1 1 1 1 1 1 1 1 1 1 1 1 1 1 1 1 1 1 1 1 1 1 1 1 1 1 1 1 1 1 1 1 1 1 1 1 1 1 1 1 1 1 1 1 1 1 1 1 1 1 1 1 1 1 1 1 1 1 1 1 1 
1 1 1 1 1 1 1 1 1 1 1 1 1 1 1 1 1 1 1 1 1 1 1 1 1 1 1 1 1 1 1 1 1 1 1 1 1 1 1 1 1 1 1 1 1 1 1 1 1 1 1 1 1 1 1 1 1 1 1 1 1 1 1 1 1 1 1 1 1 1 1 1 1 1 1 1 1 1 1 1 1 1 1 1 1 1 1 1 1 1 1 1 1 1 1 1 1 1 1 1 
1 1 1 1 1 1 1 1 1 1 1 1 1 1 1 1 1 1 1 1 1 1 1 1 1 1 1 1 1 1 1 1 1 1 1 1 1 1 1 1 1 1 1 1 1 1 1 1 1 1 1 1 1 1 1 1 1 1 1 1 1 1 1 1 1 1 1 1 1 1 1 1 1 1 1 1 1 1 1 1 1 1 1 1 1 1 1 1 1 1 1 1 1 1 1 1 1 1 1 1 
1 1 1 1 1 1 1 1 1 1 1 1 1 1 1 1 1 1 1 1 1 1 1 1 1 1 1 1 1 1 1 1 1 1 1 1 1 1 1 1 1 1 1 1 1 1 1 1 1 1 1 1 1 1 1 1 1 1 1 1 1 1 1 1 1 1 1 1 1 1 1 1 1 1 1 1 1 1 1 1 1 1 1 1 1 1 1 1 1 1 1 1 1 1 1 1 1 1 1 1 
1 1 1 1 1 1 1 1 1 1 1 1 1 1 1 1 1 1 1 1 1 1 1 1 1 1 1 1 1 1 1 1 1 1 1 1 1 1 1 1 1 1 1 1 1 1 1 1 1 1 1 1 1 1 1 1 1 1 1 1 1 1 1 1 1 1 1 1 1 1 1 1 1 1 1 1 1 1 1 1 1 1 1 1 1 1 1 1 1 1 1 1 1 1 1 1 1 1 1 1 
1 1 1 1 1 1 1 1 1 1 1 1 1 1 1 1 1 1 1 1 1 1 1 1 1 1 1 1 1 1 1 1 1 1 1 1 1 1 1 1 1 1 1 1 1 1 1 1 1 1 1 1 1 1 1 1 1 1 1 1 1 1 1 1 1 1 1 1 1 1 1 1 1 1 1 1 1 1 1 1 1 1 1 1 1 1 1 1 1 1 1 1 1 1 1 1 1 1 1 1 
1 1 1 1 1 1 1 1 1 1 1 1 1 1 1 1 1 1 1 1 1 1 1 1 1 1 1 1 1 1 1 1 1 1 1 1 1 1 1 1 1 1 1 1 1 1 1 1 1 1 1 1 1 1 1 1 1 1 1 1 1 1 1 1 1 1 1 1 1 1 1 1 1 1 1 1 1 1 1 1 1 1 1 1 1 1 1 1 1 1 1 1 1 1 1 1 1 1 1 1 
1 1 1 1 1 1 1 1 1 1 1 1 1 1 1 1 1 1 1 1 1 1 1 1 1 1 1 1 1 1 1 1 1 1 1 1 1 1 1 1 1 1 1 1 1 1 1 1 1 1 1 1 1 1 1 1 1 1 1 1 1 1 1 1 1 1 1 1 1 1 1 1 1 1 1 1 1 1 1 1 1 1 1 1 1 1 1 1 1 1 1 1 1 1 1 1 1 1 1 1 
1 1 1 1 1 1 1 1 1 1 1 1 1 1 1 1 1 1 1 1 1 1 1 1 1 1 1 1 1 1 1 1 1 1 1 1 1 1 1 1 1 1 1 1 1 1 1 1 1 1 1 1 1 1 1 1 1 1 1 1 1 1 1 1 1 1 1 1 1 1 1 1 1 1 1 1 1 1 1 1 1 1 1 1 1 1 1 1 1 1 1 1 1 1 1 1 1 1 1 1 
1 1 1 1 1 1 1 1 1 1 1 1 1 1 96 96 96 1 1 1 1 1 1 1 1 1 1 1 1 1 1 1 1 1 1 1 1 1 1 1 1 1 1 1 1 1 1 1 1 1 1 1 1 1 1 1 1 1 1 1 1 1 1 1 1 1 1 1 1 1 1 1 1 1 1 1 1 1 1 1 1 1 1 1 1 96 96 96 96 1 1 1 1 1 1 1 1 1 1 1 
1 1 1 1 1 1 1 1 1 1 1 1 1 96 96 1 96 96 1 1 96 96 96 1 1 1 1 1 1 1 1 1 1 1 1 1 1 1 1 1 1 1 1 1 1 1 1 1 1 1 1 1 1 1 1 1 1 1 1 1 1 1 1 1 1 1 1 1 1 1 1 96 96 1 1 96 96 96 96 96 96 1 96 96 96 96 96 96 96 96 1 1 1 1 1 1 1 1 1 1 
1 1 1 1 1 1 1 1 1 1 1 1 96 1 1 1 96 96 96 96 96 96 96 96 96 96 1 1 1 1 1 1 1 1 1 1 1 1 1 1 1 1 1 1 1 1 1 1 1 1 1 1 1 1 1 1 1 1 1 1 1 1 1 1 1 1 1 1 1 1 96 96 96 96 96 96 96 96 96 96 96 96 96 96 96 96 96 96 96 96 96 1 1 1 1 1 1 1 1 1 
1 1 1 1 1 1 1 1 1 1 1 1 1 96 1 51 44 44 44 44 44 44 44 44 44 44 52 96 1 1 1 1 1 1 1 1 1 1 1 1 1 1 1 1 1 1 1 1 1 1 1 1 1 1 1 1 1 1 1 1 1 1 1 1 1 1 1 1 1 1 96 96 51 44 44 44 44 44 44 44 44 44 44 44 44 44 44 44 52 96 96 1 1 1 1 1 1 1 1 1 
1 1 1 1 1 1 1 1 1 1 1 1 1 96 96 46 36 32 32 36 32 36 32 36 32 36 45 96 1 1 1 1 1 1 1 1 1 1 1 1 1 1 1 1 1 1 1 1 1 1 1 1 1 1 1 1 1 1 1 1 1 1 1 1 1 1 1 1 1 1 96 96 46 32 36 36 32 32 32 36 32 36 32 32 32 32 36 32 45 96 96 1 1 1 1 1 1 1 1 1 
1 1 1 1 1 1 1 1 1 1 1 1 1 96 96 46 32 63 60 60 60 60 60 60 64 32 45 96 1 1 1 1 1 1 1 1 1 1 1 1 1 1 1 1 1 1 1 1 1 1 1 1 1 1 1 1 1 1 1 1 1 1 1 1 1 1 1 1 1 1 96 96 46 32 32 32 32 32 32 36 36 36 32 32 36 32 36 32 45 96 96 1 1 1 1 1 1 1 1 1 
1 1 1 1 1 1 1 1 1 1 1 1 1 96 96 46 32 61 67 67 67 67 67 67 62 36 45 96 96 96 96 1 1 1 1 1 1 1 1 1 1 1 1 1 1 1 1 1 1 1 1 1 1 1 1 1 1 1 1 1 1 1 1 1 1 1 1 1 96 96 96 96 46 32 36 63 60 60 60 60 60 60 60 60 60 64 32 32 45 96 1 1 1 1 1 1 1 1 1 1 
1 1 1 1 1 1 1 1 1 1 1 1 1 96 96 46 32 61 67 67 67 67 67 67 62 36 49 44 44 44 52 96 1 1 1 1 1 1 1 1 1 1 1 1 1 1 1 1 1 1 1 1 1 1 1 1 1 1 1 1 1 1 1 1 1 1 1 1 51 44 44 44 50 32 32 61 67 67 67 67 67 67 67 67 67 62 32 32 45 96 1 1 1 1 1 1 1 1 1 1 
1 1 1 1 1 1 1 1 1 1 1 1 1 1 96 46 36 61 67 67 67 67 67 67 62 32 32 36 36 36 45 96 1 1 1 1 1 1 1 1 1 1 1 1 1 1 1 1 1 1 1 1 1 1 1 1 1 1 1 1 1 1 1 1 1 1 1 96 46 32 36 36 36 32 32 61 67 67 67 67 67 67 67 67 67 62 36 32 45 96 1 1 1 1 1 1 1 1 1 1 
1 1 1 1 1 1 1 1 1 1 1 1 1 1 96 46 32 61 67 67 67 67 67 67 57 60 60 60 64 32 45 96 1 1 1 96 96 96 96 1 96 1 1 1 1 1 1 1 1 1 1 1 1 96 96 96 96 96 1 1 1 1 96 96 96 1 1 96 46 36 32 32 32 32 32 61 67 67 67 67 67 67 67 67 67 62 32 32 45 96 1 1 1 1 1 1 1 1 1 1 
1 1 1 1 1 1 1 1 1 1 1 1 1 1 96 46 36 61 67 67 67 67 67 67 67 67 67 67 62 32 45 96 96 96 96 96 96 96 96 96 96 96 96 1 1 1 1 1 1 1 1 1 96 96 96 96 96 96 96 96 96 96 96 96 96 96 96 96 46 32 32 63 60 60 60 58 55 59 59 56 67 67 67 67 67 62 32 36 45 96 96 1 1 1 1 1 1 1 1 1 
1 1 1 1 1 1 1 1 1 1 1 1 1 1 96 46 32 61 67 67 67 67 67 67 67 67 67 67 62 36 49 44 44 44 44 44 44 44 44 44 44 52 96 1 1 1 1 1 1 1 1 1 96 51 44 44 44 44 44 44 44 44 44 44 44 44 44 44 50 32 36 61 67 67 67 67 62 36 36 65 56 67 67 67 67 62 32 32 45 96 96 1 1 1 1 1 1 1 1 1 
1 1 1 1 1 1 1 1 1 1 1 1 1 96 96 46 32 65 59 59 59 56 67 67 67 67 67 67 62 32 32 32 32 32 32 32 32 32 32 32 32 45 96 1 1 1 1 1 1 1 1 96 96 46 32 32 32 32 32 32 32 32 32 32 32 32 32 32 36 32 32 61 67 67 55 59 66 36 32 32 65 56 67 67 67 62 32 32 45 96 96 1 1 1 1 1 1 1 1 1 
1 1 1 1 1 1 1 1 1 1 1 1 1 96 96 46 36 32 36 32 32 61 67 67 67 67 67 67 62 32 36 32 32 36 32 32 32 32 32 32 32 45 96 1 1 1 1 1 1 1 1 96 96 46 32 32 32 32 32 32 36 32 32 32 32 32 32 32 32 32 32 61 67 67 62 36 36 36 32 32 36 61 67 67 67 62 36 32 45 96 96 1 1 1 1 1 1 1 1 1 
1 1 1 1 1 1 1 1 1 1 1 1 1 96 96 53 43 43 43 48 32 61 67 67 67 67 67 67 57 64 32 32 32 32 32 32 32 32 32 32 32 45 96 96 96 1 1 1 96 1 96 96 96 46 32 32 32 32 32 32 32 32 32 32 32 32 32 36 32 63 60 58 67 67 62 36 36 36 36 36 36 61 67 67 67 62 32 32 45 96 96 1 1 1 1 1 1 1 1 1 
1 1 1 1 1 1 1 1 1 1 1 1 1 1 96 96 96 96 96 46 32 61 67 67 67 67 67 67 67 57 64 32 32 36 32 32 36 32 32 32 32 49 44 44 44 52 96 96 96 51 44 44 44 50 32 32 32 32 32 32 32 32 32 36 32 32 32 32 32 61 67 67 67 67 62 36 36 36 63 60 60 58 67 67 67 62 36 36 45 96 96 1 1 1 1 1 1 1 1 1 
1 1 1 1 1 1 1 1 1 1 1 1 1 1 1 96 96 96 96 46 32 65 59 59 59 59 59 56 67 67 57 60 64 32 32 32 32 32 32 32 32 32 32 32 32 45 96 96 96 46 32 32 32 32 32 32 36 32 32 32 32 32 32 32 32 32 32 36 32 61 67 67 67 67 57 64 36 63 58 67 67 55 59 59 59 66 32 32 45 96 96 1 1 1 1 1 1 1 1 1 
1 1 1 1 1 1 1 1 1 1 1 1 1 1 1 1 1 1 96 46 36 32 32 32 32 32 32 65 56 67 67 67 57 64 32 32 36 32 32 36 36 32 32 32 32 45 96 96 96 46 32 32 32 32 32 32 32 32 32 32 32 32 32 36 32 32 32 32 36 61 67 67 67 67 67 57 60 58 67 67 67 62 32 36 32 32 36 32 45 96 96 1 1 1 1 1 1 1 1 1 
1 1 1 1 1 1 1 1 1 1 1 1 1 1 1 1 1 1 96 53 43 43 43 48 32 36 32 32 61 67 67 67 67 62 32 32 32 32 32 32 32 32 32 32 32 45 96 96 96 46 32 32 32 32 32 32 32 32 32 32 32 36 32 32 32 32 32 32 32 61 67 67 67 67 67 67 67 67 67 67 67 62 32 32 32 32 32 32 45 96 96 1 1 1 1 1 1 1 1 1 
1 1 1 1 1 1 1 1 1 1 1 1 1 1 1 1 1 1 1 96 96 96 96 46 32 32 32 32 65 59 56 67 67 62 32 32 32 32 32 32 32 36 32 32 32 49 44 44 44 50 32 32 32 32 32 32 32 32 32 32 32 32 32 32 32 36 32 36 32 61 67 67 67 67 67 67 67 67 67 67 67 62 32 36 47 43 43 43 54 96 1 1 1 1 1 1 1 1 1 1 
1 1 1 1 1 1 1 1 1 1 1 1 1 1 1 1 1 1 1 1 1 96 96 46 32 32 36 32 32 32 61 67 67 57 64 32 36 32 32 32 32 32 32 32 32 32 32 32 32 32 32 32 32 32 32 32 32 32 32 32 32 32 32 32 32 32 32 32 63 58 67 67 67 55 59 59 59 59 59 59 59 66 32 32 45 96 96 96 96 96 1 1 1 1 1 1 1 1 1 1 
1 1 1 1 1 1 1 1 1 1 1 1 1 1 1 1 1 1 1 1 1 96 96 46 32 32 32 32 32 32 65 56 67 67 62 32 32 32 32 32 32 63 60 60 60 64 32 32 32 32 32 32 32 36 36 36 36 36 32 32 32 32 32 36 32 32 32 63 58 67 67 55 59 66 36 32 32 32 36 32 32 32 32 32 45 96 96 96 1 1 1 1 1 1 1 1 1 1 1 1 
1 1 1 1 1 1 1 1 1 1 1 1 1 1 1 1 1 1 1 1 1 1 96 46 32 32 32 32 36 32 32 61 67 67 57 60 60 60 60 60 60 58 67 67 67 62 32 36 32 32 32 32 36 36 36 36 36 36 36 32 32 32 32 32 32 32 32 61 67 67 55 66 32 32 32 32 32 32 32 32 32 36 32 32 45 96 1 1 1 1 1 1 1 1 1 1 1 1 1 1 
1 1 1 1 1 1 1 1 1 1 1 1 1 1 1 1 1 1 1 1 1 1 96 46 32 32 32 32 32 36 32 61 67 67 67 67 67 67 67 67 67 67 67 67 67 62 32 32 32 32 32 36 36 36 36 36 36 36 36 36 32 32 32 32 32 36 32 61 67 55 66 32 32 32 36 32 32 36 32 32 47 43 43 43 54 1 1 1 1 1 1 1 1 1 1 1 1 1 1 1 
1 1 1 1 1 1 1 1 1 1 1 1 1 1 1 1 1 1 1 1 1 96 96 46 32 32 32 32 32 32 32 65 59 59 59 59 59 59 59 59 59 56 67 67 67 62 32 32 32 32 32 36 36 36 36 32 32 36 36 36 32 32 32 32 32 32 32 61 67 62 32 32 32 32 32 32 32 32 32 32 45 96 96 96 1 1 1 1 1 1 1 1 1 1 1 1 1 1 1 1 
1 1 1 1 1 1 1 1 1 1 1 1 1 1 1 1 1 1 1 1 1 96 96 46 32 32 32 36 32 32 32 32 32 32 36 32 32 32 32 32 32 65 56 67 55 66 32 32 32 32 32 36 36 36 32 32 32 36 36 36 32 32 32 32 32 32 32 61 67 62 32 32 36 32 32 36 32 36 32 32 45 96 96 96 1 1 1 1 1 1 1 1 1 1 1 1 1 1 1 1 
1 1 1 1 1 1 1 1 1 1 1 1 1 1 1 1 1 1 1 1 1 96 96 46 32 32 32 32 32 32 32 36 32 32 32 32 32 32 36 32 32 32 61 67 62 32 32 32 32 32 32 36 36 36 32 32 36 36 36 36 32 32 32 32 32 36 32 61 67 62 32 32 32 32 32 32 32 32 32 32 45 96 96 96 1 1 1 1 1 1 1 1 1 1 1 1 1 1 1 1 
1 1 1 1 1 1 1 1 1 1 1 1 1 1 1 1 1 1 1 1 1 1 96 46 32 32 32 32 32 32 32 32 32 32 32 36 32 32 32 32 36 32 61 67 62 36 32 32 36 32 32 32 36 36 32 32 36 36 36 32 32 32 36 36 32 32 32 61 67 62 32 32 32 32 32 32 32 32 32 32 45 96 96 96 1 1 1 1 1 1 1 1 1 1 1 1 1 1 1 1 
1 1 1 1 1 1 1 1 1 1 1 1 1 1 1 1 1 1 1 1 96 96 96 46 32 32 32 32 32 32 32 32 32 32 32 32 32 32 32 32 32 32 61 67 62 32 32 32 32 32 32 32 32 36 32 36 36 36 32 32 32 32 32 32 32 32 32 61 67 62 32 32 32 32 32 32 32 32 32 32 45 96 96 96 1 1 1 1 1 1 1 1 1 1 1 1 1 1 1 1 
1 1 1 1 1 1 1 1 1 1 1 1 1 1 1 1 1 1 1 51 44 44 44 50 32 32 32 32 32 32 32 32 32 32 32 36 32 32 32 32 36 32 61 67 62 32 32 32 32 32 32 32 32 32 32 32 32 32 32 32 32 32 32 32 32 32 32 61 67 62 32 32 32 32 32 32 32 32 32 32 45 96 96 1 1 1 1 1 1 1 1 1 1 1 1 1 1 1 1 1 
1 1 1 1 1 1 1 1 1 1 1 1 1 1 1 1 1 1 96 46 32 32 32 32 32 32 32 32 32 32 32 32 32 32 32 32 32 32 36 32 32 32 61 67 62 32 32 32 32 32 32 32 32 32 32 32 32 32 32 32 32 32 36 32 32 36 32 61 67 62 32 32 32 32 32 32 32 32 32 32 45 96 96 1 1 1 1 1 1 1 1 1 1 1 1 1 1 1 1 1 
1 1 1 1 1 1 1 1 1 1 1 1 1 1 1 1 1 1 96 46 32 32 32 32 63 60 60 60 60 60 64 32 32 32 32 32 32 32 32 32 32 32 61 67 62 32 32 32 32 32 32 36 32 32 32 32 32 32 32 32 32 32 32 32 32 32 32 61 67 62 32 32 32 32 32 32 32 32 32 32 45 96 96 1 1 1 1 1 1 1 1 1 1 1 1 1 1 1 1 1 
1 1 1 1 1 1 1 1 1 1 1 1 1 1 1 1 96 96 96 46 32 32 63 60 58 67 67 67 67 67 62 32 32 32 32 32 36 32 32 32 36 32 61 67 62 32 32 32 32 32 32 32 32 32 32 32 32 32 36 32 32 32 32 32 32 32 32 61 67 62 32 32 32 32 32 32 32 32 32 32 45 96 96 1 1 1 1 1 1 1 1 1 1 1 1 1 1 1 1 1 
1 1 1 1 1 1 1 1 1 1 1 1 1 1 96 51 44 44 44 50 32 32 61 67 67 67 67 67 67 67 57 64 32 32 32 32 32 32 32 32 32 32 61 67 62 36 32 32 36 32 32 32 32 32 32 32 36 32 32 32 32 32 32 36 32 32 32 61 67 62 32 32 32 32 32 32 32 32 32 32 45 96 96 1 1 1 1 1 1 1 1 1 1 1 1 1 1 1 1 1 
1 1 1 1 1 1 1 1 1 1 1 1 1 1 96 46 32 32 32 32 32 32 61 67 67 67 67 67 67 67 67 62 63 60 64 32 32 32 32 32 32 36 61 67 62 32 32 32 32 32 32 32 32 32 32 32 32 32 32 32 32 32 32 32 32 32 32 61 67 62 32 32 32 32 32 32 32 32 32 32 45 96 1 1 1 1 1 1 1 1 1 1 1 1 1 1 1 1 1 1 
1 1 1 1 1 1 1 1 1 1 1 1 96 96 96 46 32 32 32 32 63 60 58 67 67 67 67 67 67 67 67 57 58 67 62 32 32 36 32 32 32 32 61 67 62 32 32 32 32 32 32 32 32 36 32 32 32 32 32 32 32 32 32 32 32 32 36 61 67 62 32 32 32 32 32 32 32 32 32 32 45 96 1 96 96 1 1 1 1 1 1 1 1 1 1 1 1 1 1 1 
1 1 1 1 1 1 1 1 1 1 1 1 96 96 96 46 32 32 63 60 58 67 67 67 67 67 67 67 67 67 67 67 67 67 62 32 32 32 32 32 36 32 61 67 62 32 32 32 32 32 32 32 32 32 32 32 32 32 32 32 32 36 32 32 32 32 32 61 67 62 32 32 32 32 32 32 32 32 32 32 45 96 96 96 96 96 1 1 1 1 1 1 1 1 1 1 1 1 1 1 
1 1 1 1 1 1 1 1 1 1 1 51 44 44 44 50 32 63 58 67 67 67 67 67 67 67 67 67 67 67 67 67 67 67 62 32 32 32 32 32 36 32 61 67 62 32 32 32 36 32 32 32 32 32 32 32 32 32 32 32 32 32 32 32 32 32 32 61 67 62 32 32 32 32 32 32 32 32 32 32 49 44 44 44 52 96 1 1 1 1 1 1 1 1 1 1 1 1 1 1 
1 1 1 1 1 1 1 1 1 96 96 46 32 32 32 32 32 61 67 67 67 67 67 67 67 67 67 67 67 67 67 67 67 67 62 36 32 36 32 32 32 32 61 67 62 32 32 32 32 32 32 32 32 32 32 36 32 32 32 36 32 36 32 32 36 32 32 61 67 62 32 32 32 32 32 32 32 32 32 32 36 36 36 36 45 96 1 1 1 1 1 1 1 1 1 1 1 1 1 1 
1 1 1 1 1 1 1 1 1 96 96 46 32 63 60 60 60 58 67 67 67 67 67 67 67 67 67 67 67 67 67 67 67 67 62 32 32 32 32 32 32 63 58 67 57 64 32 32 32 32 32 32 36 32 32 32 32 32 32 32 32 32 32 32 32 32 63 58 67 57 64 32 32 32 32 32 32 32 32 36 36 36 36 32 45 96 96 1 1 1 1 1 1 1 1 1 1 1 1 1 
1 1 1 1 1 1 1 1 1 96 96 46 32 61 67 67 67 67 67 67 67 67 67 67 67 67 67 67 67 67 67 67 67 67 57 60 60 60 60 60 60 58 67 67 67 57 60 60 60 60 60 60 60 60 60 60 60 60 60 60 60 60 60 60 60 60 58 67 67 67 57 60 60 60 60 60 60 60 60 60 64 137 131 136 45 96 96 1 1 1 1 1 1 1 1 1 1 1 1 1 
1 1 1 1 1 1 1 1 1 96 96 46 32 61 67 67 67 67 67 67 67 67 67 67 67 67 67 67 67 67 67 67 67 67 67 67 67 67 67 67 67 67 67 67 67 67 67 67 67 67 67 67 67 67 67 67 67 67 67 67 67 67 67 67 67 67 67 67 67 67 67 67 67 67 67 67 67 67 67 67 62 130 32 129 45 96 96 1 1 1 1 1 1 1 1 1 1 1 1 1 
1 1 1 1 1 1 1 1 1 96 96 46 32 61 67 67 67 67 67 67 67 67 67 67 67 67 67 67 67 67 67 67 67 67 55 59 59 59 59 59 59 56 67 67 67 55 59 59 59 59 59 59 59 59 59 59 59 59 59 59 59 59 59 59 59 59 56 67 67 67 55 59 59 59 59 59 59 59 59 59 66 133 132 134 45 96 1 1 1 1 1 1 1 1 1 1 1 1 1 1 
1 1 1 1 1 1 1 1 1 96 96 46 32 65 59 59 59 56 67 67 67 67 67 67 67 67 67 67 67 67 67 67 67 67 62 32 32 32 32 32 32 65 56 67 55 66 32 32 36 32 32 32 32 32 32 36 32 32 32 36 32 32 32 32 32 32 65 56 67 55 66 32 32 32 32 32 32 32 32 36 36 36 36 32 45 96 1 1 1 1 1 1 1 1 1 1 1 1 1 1 
1 1 1 1 1 1 1 1 1 96 96 46 32 32 32 32 32 61 67 67 67 67 67 67 67 67 67 67 67 67 67 67 67 67 62 32 32 36 32 32 36 32 61 67 62 32 32 32 32 32 32 32 36 32 32 32 32 32 32 32 32 32 32 32 36 32 32 61 67 62 32 32 32 32 32 32 32 32 32 32 36 36 36 36 45 96 1 1 1 1 1 1 1 1 1 1 1 1 1 1 
1 1 1 1 1 1 1 1 1 96 96 53 43 43 43 48 32 65 56 67 67 67 67 67 67 67 67 67 67 67 67 67 67 55 66 36 32 32 32 32 32 32 61 67 62 32 36 32 32 47 43 48 36 47 43 43 43 43 43 48 36 32 36 32 32 32 32 61 67 62 32 32 32 32 32 32 32 32 32 32 47 43 43 43 54 1 1 1 1 1 1 1 1 1 1 1 1 1 1 1 
1 1 1 1 1 1 1 1 1 1 96 1 96 96 96 46 32 32 65 56 67 67 67 67 67 67 67 67 67 67 67 67 55 66 32 32 32 32 32 36 32 32 61 67 62 32 32 32 32 45 96 53 43 54 96 96 96 96 96 53 43 48 32 32 32 32 32 61 67 62 32 32 32 32 32 32 32 32 32 32 45 96 96 96 96 1 1 1 1 1 1 1 1 1 1 1 1 1 1 1 
1 1 1 1 1 1 1 1 1 1 1 1 1 1 96 46 32 32 32 65 59 56 67 67 67 67 67 67 67 67 67 55 66 32 32 32 32 32 32 32 32 32 61 67 62 36 32 32 32 49 52 96 96 96 96 96 96 96 96 96 96 53 48 32 32 32 32 61 67 62 32 32 32 32 32 32 32 32 32 32 45 96 96 1 1 1 1 1 1 1 1 1 1 1 1 1 1 1 1 1 
1 1 1 1 1 1 1 1 1 1 1 1 1 1 96 46 32 32 32 32 32 61 67 67 67 67 67 67 67 67 67 62 32 32 32 32 32 36 32 32 32 32 61 67 62 32 32 36 32 32 45 96 96 96 96 96 96 96 96 96 96 96 46 32 36 32 32 61 67 62 32 32 32 32 32 32 32 32 32 32 45 96 1 1 1 1 1 1 1 1 1 1 1 1 1 1 1 1 1 1 
1 1 1 1 1 1 1 1 1 1 1 1 1 1 96 53 43 43 43 48 32 65 56 67 67 67 67 67 67 67 67 62 32 32 32 36 32 32 32 32 36 32 61 67 62 32 32 32 32 47 54 96 96 96 96 96 96 96 96 96 96 96 46 32 32 36 32 61 67 62 32 32 32 32 32 32 32 32 32 32 45 96 1 1 1 1 1 1 1 1 1 1 1 1 1 1 1 1 1 1 
1 1 1 1 1 1 1 1 1 1 1 1 1 1 96 1 96 96 96 46 32 32 65 56 67 67 67 67 67 67 55 66 32 32 32 32 32 32 32 32 32 32 61 67 62 36 32 32 32 45 96 96 96 96 96 1 96 96 96 96 96 96 46 32 32 32 32 61 67 62 32 32 32 32 32 32 32 32 32 32 45 96 1 1 1 1 1 1 1 1 1 1 1 1 1 1 1 1 1 1 
1 1 1 1 1 1 1 1 1 1 1 1 1 1 1 1 1 96 96 46 32 32 32 65 59 59 59 59 59 59 66 32 32 32 32 32 32 32 32 32 36 32 61 67 62 32 32 32 47 54 96 96 96 96 96 1 96 96 96 96 96 96 46 32 32 32 32 61 67 62 32 32 32 32 32 32 32 32 32 32 45 96 96 1 1 1 1 1 1 1 1 1 1 1 1 1 1 1 1 1 
1 1 1 1 1 1 1 1 1 1 1 1 1 1 1 1 1 1 96 46 32 32 32 32 32 32 32 32 32 32 32 32 32 32 32 32 32 32 32 32 36 32 61 67 62 32 32 32 45 96 96 96 96 1 1 1 1 96 96 96 96 96 46 32 32 36 32 61 67 62 32 32 32 32 32 32 32 32 32 32 45 96 96 1 1 1 1 1 1 1 1 1 1 1 1 1 1 1 1 1 
1 1 1 1 1 1 1 1 1 1 1 1 1 1 1 1 1 1 96 53 43 43 43 48 32 32 32 32 32 32 32 32 32 32 32 32 32 32 36 32 32 32 61 67 62 32 36 32 45 96 96 96 96 96 1 1 1 1 1 96 96 51 50 32 32 32 32 61 67 62 32 32 32 32 32 32 32 32 32 32 45 96 96 1 1 1 1 1 1 1 1 1 1 1 1 1 1 1 1 1 
1 1 1 1 1 1 1 1 1 1 1 1 1 1 1 1 1 1 1 1 96 96 96 46 32 32 32 32 32 36 32 32 32 32 36 32 32 32 32 32 32 32 61 67 62 32 32 32 45 96 96 96 96 96 96 1 96 96 96 96 96 46 32 32 32 32 32 61 67 62 32 32 32 32 32 32 32 32 32 32 45 96 1 1 1 1 1 1 1 1 1 1 1 1 1 1 1 1 1 1 
1 1 1 1 1 1 1 1 1 1 1 1 1 1 1 1 1 1 1 1 1 1 96 46 32 32 32 32 32 32 32 32 32 32 32 32 32 32 32 32 36 32 61 67 62 36 32 32 49 52 96 96 96 96 96 96 96 96 96 96 96 46 32 32 32 36 32 61 67 62 36 32 32 32 36 32 32 32 32 32 45 96 96 1 1 1 1 1 1 1 1 1 1 1 1 1 1 1 1 1 
1 1 1 1 1 1 1 1 1 1 1 1 1 1 1 1 1 1 1 1 1 1 96 46 32 32 32 32 32 32 32 32 32 32 32 32 32 32 32 32 32 32 61 67 62 32 32 32 32 45 96 96 1 1 96 96 96 96 96 1 96 53 48 32 32 32 32 61 67 62 32 32 32 32 32 32 32 36 32 32 45 96 96 1 1 1 1 1 1 1 1 1 1 1 1 1 1 1 1 1 
1 1 1 1 1 1 1 1 1 1 1 1 1 1 1 1 1 1 1 1 1 96 96 46 32 32 32 32 32 32 32 32 32 32 32 32 36 32 32 36 32 32 61 67 62 36 32 32 32 49 44 52 96 96 96 96 51 44 52 1 1 96 46 32 32 36 32 61 67 62 32 32 32 32 36 32 36 32 32 32 45 96 96 96 96 1 1 1 1 1 1 1 1 1 1 1 1 1 1 1 
1 1 1 1 1 1 1 1 1 1 1 1 1 1 1 1 1 1 1 1 96 96 96 46 32 32 32 32 32 32 32 32 36 32 32 32 36 32 32 36 32 32 61 67 62 32 32 32 32 32 32 45 96 96 51 44 50 32 49 52 96 51 50 32 36 32 36 61 67 62 32 36 32 32 32 32 32 32 32 32 45 96 96 96 96 96 1 1 1 1 1 1 1 1 1 1 1 1 1 1 
1 1 1 1 1 1 1 1 1 1 1 1 1 1 1 1 1 1 1 1 96 96 96 46 32 36 32 32 32 36 32 32 36 32 32 32 32 32 32 32 32 63 58 67 57 64 32 32 32 32 32 49 44 44 50 32 32 32 32 49 44 50 32 32 32 32 32 61 67 57 64 32 32 32 36 32 32 32 32 32 49 44 44 44 52 96 96 1 1 1 1 1 1 1 1 1 1 1 1 1 
1 1 1 1 1 1 1 1 1 1 1 1 1 1 1 1 1 1 1 1 96 96 96 46 32 32 32 32 32 32 32 32 32 32 32 63 60 60 60 60 60 58 67 67 67 62 32 32 36 36 36 32 32 32 32 36 32 32 32 32 32 32 32 32 32 32 32 61 67 67 62 32 32 32 32 32 32 36 32 32 32 32 32 32 45 96 96 1 1 1 1 1 1 1 1 1 1 1 1 1 
1 1 1 1 1 1 1 1 1 1 1 1 1 1 1 1 1 1 1 1 96 96 96 46 32 32 36 32 32 36 32 63 60 60 60 58 67 67 67 67 67 67 67 67 67 62 32 32 32 36 32 32 36 32 32 32 32 32 36 32 32 32 32 32 32 36 32 61 67 67 57 60 64 32 36 32 32 32 32 32 32 32 36 32 45 96 96 96 96 1 1 1 1 1 1 1 1 1 1 1 
1 1 1 1 1 1 1 1 1 1 1 1 1 1 1 1 1 1 1 1 1 96 96 46 32 32 32 32 32 63 60 58 67 67 67 67 67 67 55 59 59 56 67 67 67 62 32 32 32 32 32 32 32 32 32 32 32 32 32 32 32 32 32 32 32 32 32 65 56 67 67 67 57 64 32 63 60 60 60 60 60 64 32 32 45 96 96 96 96 1 1 1 1 1 1 1 1 1 1 1 
1 1 1 1 1 1 1 1 1 1 1 1 1 1 1 1 1 1 1 96 96 96 96 46 32 32 32 32 63 58 67 67 67 55 59 59 59 59 66 32 32 65 59 59 59 66 32 32 32 32 32 32 32 32 32 32 36 32 32 32 32 32 32 32 32 32 32 32 65 59 56 67 67 57 60 58 67 67 67 67 67 62 32 32 49 44 44 44 52 96 1 1 1 1 1 1 1 1 1 1 
1 1 1 1 1 1 1 1 1 1 1 1 1 1 1 1 1 1 96 51 44 44 44 50 32 36 32 63 58 67 67 67 55 66 32 32 32 32 32 32 32 32 32 32 32 32 32 32 32 32 32 32 32 32 32 32 32 32 32 32 32 32 36 32 32 32 32 36 32 32 65 56 67 67 67 67 67 67 67 67 67 62 36 32 32 32 32 36 45 96 1 1 1 1 1 1 1 1 1 1 
1 1 1 1 1 1 1 1 1 1 1 1 1 1 1 1 1 1 96 46 36 32 32 36 32 32 63 58 67 67 55 59 66 32 36 32 32 32 32 32 32 32 36 32 32 32 32 32 36 32 32 32 36 32 32 32 32 32 36 32 32 32 32 32 32 36 32 36 32 32 36 65 56 67 67 67 67 67 67 67 67 62 32 32 32 32 32 32 45 96 1 1 1 1 1 1 1 1 1 1 
1 1 1 1 1 1 1 1 1 1 1 1 1 1 1 1 1 96 96 46 32 63 60 60 60 60 58 67 67 55 66 32 32 32 32 32 32 32 32 36 32 32 32 32 32 32 32 36 36 32 32 32 32 32 32 32 32 32 32 32 32 32 32 32 32 32 32 32 32 32 32 63 58 67 67 67 67 67 67 67 67 57 60 60 60 64 32 32 45 96 96 1 1 1 1 1 1 1 1 1 
1 1 1 1 1 1 1 1 1 1 1 1 1 1 1 96 96 96 96 46 32 61 67 67 67 67 67 67 55 66 32 32 36 32 32 36 32 32 32 32 32 32 32 32 32 32 36 32 32 32 32 32 32 32 32 32 32 36 32 32 32 32 32 32 36 32 32 32 32 36 32 61 67 67 67 67 67 67 67 67 67 67 67 67 67 62 32 32 45 96 96 1 1 1 1 1 1 1 1 1 
1 1 1 1 1 1 1 1 1 1 1 1 1 1 96 51 44 44 44 50 32 61 67 67 67 67 67 67 62 32 36 32 32 32 32 32 32 32 32 32 36 36 32 36 32 32 32 32 32 32 36 32 32 32 32 32 32 32 32 32 36 32 32 32 32 32 32 36 32 32 32 61 67 67 67 67 67 67 67 67 67 67 67 67 67 62 36 32 45 96 96 1 1 1 1 1 1 1 1 1 
1 1 1 1 1 1 1 1 1 1 1 1 1 1 1 46 36 32 32 36 32 61 67 67 67 67 67 67 62 32 36 32 32 32 36 32 32 32 32 36 32 32 32 32 32 32 32 32 32 32 32 32 32 32 36 32 32 32 32 32 32 32 32 32 32 32 32 32 32 32 32 61 67 67 67 67 67 67 67 67 67 67 67 67 67 62 32 32 45 96 96 1 1 1 1 1 1 1 1 1 
1 1 1 1 1 1 1 1 1 1 1 1 1 1 96 46 32 63 60 60 60 58 67 67 67 67 67 67 62 32 32 32 32 32 32 32 32 32 32 32 32 32 32 32 32 36 32 32 36 32 32 32 32 32 32 32 32 32 32 32 32 32 32 32 32 32 32 32 32 32 36 61 67 67 67 67 67 67 67 67 67 67 67 67 67 62 32 36 45 96 96 1 1 1 1 1 1 1 1 1 
1 1 1 1 1 1 1 1 1 1 1 1 1 1 96 46 32 61 67 67 67 67 67 67 67 67 67 67 62 32 47 43 43 43 43 43 43 43 43 43 43 48 32 32 32 32 32 32 32 32 32 32 32 47 43 43 43 43 43 43 43 43 43 43 43 43 43 43 48 32 32 61 67 67 67 67 67 67 67 67 67 67 67 67 55 66 32 32 45 96 96 1 1 1 1 1 1 1 1 1 
1 1 1 1 1 1 1 1 1 1 1 1 1 96 96 46 32 61 67 67 67 67 67 67 67 67 67 67 62 36 45 96 96 96 96 96 96 96 96 96 96 46 32 36 32 32 32 32 32 32 36 32 32 45 96 96 96 96 96 96 96 96 96 96 96 96 96 96 46 32 32 65 59 59 59 56 67 67 67 67 67 67 55 59 66 36 32 32 45 96 1 1 1 1 1 1 1 1 1 1 
1 1 1 1 1 1 1 1 1 1 1 1 1 96 96 46 36 61 67 55 59 56 67 67 55 59 59 59 66 32 45 96 96 96 96 96 96 96 96 96 96 46 32 36 36 36 32 32 32 32 32 32 32 45 96 96 1 96 96 96 96 96 96 96 1 1 96 96 46 36 32 32 32 36 32 61 67 67 67 67 67 67 62 36 36 36 32 32 45 96 1 1 1 1 1 1 1 1 1 1 
1 1 1 1 1 1 1 1 1 1 1 1 1 96 96 46 32 61 67 62 36 61 67 67 62 36 32 32 36 32 45 96 1 96 96 96 96 1 1 1 96 46 32 32 32 32 32 32 32 32 32 32 32 45 96 1 1 1 1 1 1 1 1 1 1 1 1 96 46 32 32 36 32 32 32 61 67 67 67 67 67 55 66 32 32 36 32 32 45 96 96 1 1 1 1 1 1 1 1 1 
1 1 1 1 1 1 1 1 1 1 1 1 1 96 96 46 36 61 67 57 60 58 67 67 62 32 47 43 43 43 54 96 1 1 1 1 1 1 1 1 1 53 43 43 43 48 32 32 32 47 43 43 43 54 96 1 1 1 1 1 1 1 1 1 1 1 1 96 53 43 43 43 48 32 36 61 67 67 67 67 55 66 36 32 36 36 32 32 45 96 96 1 1 1 1 1 1 1 1 1 
1 1 1 1 1 1 1 1 1 1 1 1 1 96 96 46 32 61 67 67 67 67 67 67 62 32 45 96 96 96 96 96 1 1 1 1 1 1 1 1 1 1 96 96 96 46 32 32 32 45 96 96 96 96 96 1 1 1 1 1 1 1 1 1 1 1 1 96 96 96 96 96 46 32 32 65 59 59 59 59 66 36 36 36 36 36 32 32 45 96 96 1 1 1 1 1 1 1 1 1 
1 1 1 1 1 1 1 1 1 1 1 1 1 1 96 46 32 65 59 59 59 59 59 59 66 32 45 96 96 96 96 1 1 1 1 1 1 1 1 1 1 1 96 96 96 46 32 32 32 45 96 96 1 1 1 1 1 1 1 1 1 1 1 1 1 1 1 96 96 96 96 96 46 32 36 32 36 32 32 32 32 36 32 32 32 32 36 32 45 96 96 1 1 1 1 1 1 1 1 1 
1 1 1 1 1 1 1 1 1 1 1 1 1 1 96 46 36 32 32 32 36 32 32 32 32 36 45 96 1 1 1 1 1 1 1 1 1 1 1 1 1 1 96 96 96 46 32 32 32 45 96 96 1 1 1 1 1 1 1 1 1 1 1 1 1 1 1 1 1 96 96 96 46 32 32 32 32 36 32 32 32 32 32 32 36 32 32 32 45 96 96 1 1 1 1 1 1 1 1 1 
1 1 1 1 1 1 1 1 1 1 1 1 1 1 96 53 43 43 43 43 43 43 43 43 43 43 54 96 1 1 1 1 1 1 1 1 1 1 1 1 1 1 96 96 96 53 43 43 43 54 96 96 1 1 1 1 1 1 1 1 1 1 1 1 1 1 1 1 1 1 96 96 53 43 43 43 43 43 43 43 43 43 43 43 43 43 43 43 54 96 96 1 1 1 1 1 1 1 1 1 
1 1 1 1 1 1 1 1 1 1 1 1 1 1 96 96 96 96 96 96 96 96 96 96 96 96 96 96 1 1 1 1 1 1 1 1 1 1 1 1 1 1 1 1 96 96 96 96 96 96 96 96 1 1 1 1 1 1 1 1 1 1 1 1 1 1 1 1 1 1 1 1 96 96 96 96 96 96 96 96 96 96 96 96 96 96 96 96 96 96 1 1 1 1 1 1 1 1 1 1 
1 1 1 1 1 1 1 1 1 1 1 1 1 1 1 1 96 96 96 96 96 96 96 1 1 1 1 1 1 1 1 1 1 1 1 1 1 1 1 1 1 1 1 1 1 96 96 96 1 1 1 1 1 1 1 1 1 1 1 1 1 1 1 1 1 1 1 1 1 1 1 1 1 1 1 1 1 96 96 96 96 96 1 1 96 96 96 96 1 1 1 1 1 1 1 1 1 1 1 1 
1 1 1 1 1 1 1 1 1 1 1 1 1 1 1 1 1 1 1 96 96 1 1 1 1 1 1 1 1 1 1 1 1 1 1 1 1 1 1 1 1 1 1 1 1 1 1 1 1 1 1 1 1 1 1 1 1 1 1 1 1 1 1 1 1 1 1 1 1 1 1 1 1 1 1 1 1 1 1 1 1 1 1 1 1 1 1 1 1 1 1 1 1 1 1 1 1 1 1 1 
1 1 1 1 1 1 1 1 1 1 1 1 1 1 1 1 1 1 1 1 1 1 1 1 1 1 1 1 1 1 1 1 1 1 1 1 1 1 1 1 1 1 1 1 1 1 1 1 1 1 1 1 1 1 1 1 1 1 1 1 1 1 1 1 1 1 1 1 1 1 1 1 1 1 1 1 1 1 1 1 1 1 1 1 1 1 1 1 1 1 1 1 1 1 1 1 1 1 1 1 
1 1 1 1 1 1 1 1 1 1 1 1 1 1 1 1 1 1 1 1 1 1 1 1 1 1 1 1 1 1 1 1 1 1 1 1 1 1 1 1 1 1 1 1 1 1 1 1 1 1 1 1 1 1 1 1 1 1 1 1 1 1 1 1 1 1 1 1 1 1 1 1 1 1 1 1 1 1 1 1 1 1 1 1 1 1 1 1 1 1 1 1 1 1 1 1 1 1 1 1 
1 1 1 1 1 1 1 1 1 1 1 1 1 1 1 1 1 1 1 1 1 1 1 1 1 1 1 1 1 1 1 1 1 1 1 1 1 1 1 1 1 1 1 1 1 1 1 1 1 1 1 1 1 1 1 1 1 1 1 1 1 1 1 1 1 1 1 1 1 1 1 1 1 1 1 1 1 1 1 1 1 1 1 1 1 1 1 1 1 1 1 1 1 1 1 1 1 1 1 1 
1 1 1 1 1 1 1 1 1 1 1 1 1 1 1 1 1 1 1 1 1 1 1 1 1 1 1 1 1 1 1 1 1 1 1 1 1 1 1 1 1 1 1 1 1 1 1 1 1 1 1 1 1 1 1 1 1 1 1 1 1 1 1 1 1 1 1 1 1 1 1 1 1 1 1 1 1 1 1 1 1 1 1 1 1 1 1 1 1 1 1 1 1 1 1 1 1 1 1 1 
1 1 1 1 1 1 1 1 1 1 1 1 1 1 1 1 1 1 1 1 1 1 1 1 1 1 1 1 1 1 1 1 1 1 1 1 1 1 1 1 1 1 1 1 1 1 1 1 1 1 1 1 1 1 1 1 1 1 1 1 1 1 1 1 1 1 1 1 1 1 1 1 1 1 1 1 1 1 1 1 1 1 1 1 1 1 1 1 1 1 1 1 1 1 1 1 1 1 1 1 
1 1 1 1 1 1 1 1 1 1 1 1 1 1 1 1 1 1 1 1 1 1 1 1 1 1 1 1 1 1 1 1 1 1 1 1 1 1 1 1 1 1 1 1 1 1 1 1 1 1 1 1 1 1 1 1 1 1 1 1 1 1 1 1 1 1 1 1 1 1 1 1 1 1 1 1 1 1 1 1 1 1 1 1 1 1 1 1 1 1 1 1 1 1 1 1 1 1 1 1 
1 1 1 1 1 1 1 1 1 1 1 1 1 1 1 1 1 1 1 1 1 1 1 1 1 1 1 1 1 1 1 1 1 1 1 1 1 1 1 1 1 1 1 1 1 1 1 1 1 1 1 1 1 1 1 1 1 1 1 1 1 1 1 1 1 1 1 1 1 1 1 1 1 1 1 1 1 1 1 1 1 1 1 1 1 1 1 1 1 1 1 1 1 1 1 1 1 1 1 1 
1 1 1 1 1 1 1 1 1 1 1 1 1 1 1 1 1 1 1 1 1 1 1 1 1 1 1 1 1 1 1 1 1 1 1 1 1 1 1 1 1 1 1 1 1 1 1 1 1 1 1 1 1 1 1 1 1 1 1 1 1 1 1 1 1 1 1 1 1 1 1 1 1 1 1 1 1 1 1 1 1 1 1 1 1 1 1 1 1 1 1 1 1 1 1 1 1 1 1 1 
