12 12 12 12 12 12 12 12 12 12
12 12 12 30 29 29 29 29 34 12
12 12 12 25 10 12 12 12 26 12
12 12 30 12 10 10 14 12 26 12
12 12 25 36 39 37 14 26 12 12
12 12 25 40 14 14 14 26 12 12
12 25 10 38 38 35 14 41 26 12
12 25 10 10 10 40 14 41 26 12
12 12 31 24 24 36 14 24 33 12
12 12 12 12 12 24 24 12 12 12