12 12 12 12 12 12 12 12 12 12 12 12 12 12 12 12 12 12 12 12 12 12
12 12 12 12 12 12 12 12 12 12 12 12 12 12 12 12 12 12 12 12 12 12
12 12 12 12 12 12 12 12 12 12 12 12 12 12 12 12 12 12 12 12 12 12
12 12 12 12 12 12 12 12 12 12 12 12 12 12 12 12 12 12 12 12 12 12
12 12 12 12 12 12 12 12 12 12 12 12 12 12 12 12 12 12 12 12 12 12
12 12 12 12 12 12 12 12 12 12 12 12 12 12 12 12 12 12 12 12 12 12
12 12 12 12 12 30 29 29 29 29 29 29 31 12 12 12 12 12 12 12 12 12
12 12 12 12 12 25 10 17 10 10 10 17 27 29 29 31 12 12 12 12 12 12
12 12 12 12 12 25 17 10 10 42 39 39 39 39 43 26 12 12 12 12 12 12
12 12 12 12 12 32 24 24 23 40 14 14 14 14 41 26 12 12 12 12 12 12
12 12 12 12 12 12 12 12 25 40 14 34 35 14 41 26 12 12 12 12 12 12
12 12 12 12 12 12 12 12 25 40 14 36 37 14 41 26 12 12 12 12 12 12
12 12 12 12 12 12 12 12 25 40 14 14 14 14 41 26 12 12 12 12 12 12
12 12 12 12 12 12 12 12 25 44 38 38 38 45 17 26 12 12 12 12 12 12
12 12 12 12 12 12 12 12 32 24 24 24 24 24 24 33 12 12 12 12 12 12
12 12 12 12 12 12 12 12 12 12 12 12 12 12 12 12 12 12 12 12 12 12
12 12 12 12 12 12 12 12 12 12 12 12 12 12 12 12 12 12 12 12 12 12
12 12 12 12 12 12 12 12 12 12 12 12 12 12 12 12 12 12 12 12 12 12
12 12 12 12 12 12 12 12 12 12 12 12 12 12 12 12 12 12 12 12 12 12
12 12 12 12 12 12 12 12 12 12 12 12 12 12 12 12 12 12 12 12 12 12
12 12 12 12 12 12 12 12 12 12 12 12 12 12 12 12 12 12 12 12 12 12
12 12 12 12 12 12 12 12 12 12 12 12 12 12 12 12 12 12 12 12 12 12
